// 0. void
// 1. wall
// 2. earth
// 3. grass
// 4. bricks
// 5. tree

1 1 1 1 1 1 1 1 1 1 1 1 1 1 1 1 1 1 1 1 1 1 1 1 1 1 1 1 1 1 1 1 1 1 1 1 1 1 1 1 1 1 1 1 1 1 1 1 1 1 1 1 1 1 1 1 1 1 1 1
1 3 3 3 3 3 3 1 0 0 0 0 0 0 0 0 0 0 0 2 2 0 0 0 0 0 0 0 0 4 4 4 4 0 0 0 0 0 0 0 0 0 0 0 0 0 0 0 0 0 0 0 1 3 3 3 3 3 3 1
1 3 3 3 3 3 3 1 1 1 1 1 1 1 1 1 1 1 1 2 2 1 1 1 1 1 1 1 1 4 4 4 4 1 1 1 1 1 1 1 1 1 1 1 1 1 1 1 0 0 0 0 1 3 3 3 3 3 3 1
1 3 3 3 3 3 3 4 2 2 2 2 2 2 2 2 2 2 2 2 2 2 2 2 2 2 2 2 2 2 2 2 2 2 2 2 2 2 2 2 2 2 2 2 2 2 2 1 0 0 0 0 1 3 3 3 3 3 3 1
1 3 3 3 3 3 3 4 2 2 2 2 2 2 2 2 2 2 2 2 2 2 2 2 2 2 2 2 2 2 2 2 2 2 2 2 2 2 2 2 2 2 2 2 2 2 2 1 0 0 0 0 1 3 3 3 3 3 3 1
1 3 3 3 3 3 3 1 1 1 1 1 1 1 1 1 1 1 1 2 2 1 1 1 1 1 1 1 1 1 1 1 1 1 1 1 1 1 1 1 1 1 1 1 1 2 2 1 0 0 0 0 1 3 3 3 3 3 3 1
1 1 1 4 4 1 1 1 0 0 0 0 0 0 0 0 0 0 0 2 2 0 0 0 0 0 0 0 0 0 0 0 0 0 0 0 0 0 0 0 0 0 0 0 1 2 2 1 0 0 0 0 1 3 3 3 3 3 3 1
1 0 1 2 2 1 0 0 0 1 1 1 1 1 1 1 1 1 1 2 2 1 1 1 1 1 1 1 1 1 1 1 1 1 1 1 1 1 1 0 0 1 1 1 1 4 4 1 0 0 0 0 1 3 3 3 3 3 3 1
1 0 1 2 2 1 0 0 0 1 2 2 2 2 2 2 2 2 2 2 2 2 2 2 2 2 2 4 3 3 3 3 3 3 3 3 3 3 1 0 0 1 3 3 3 3 3 1 0 0 0 0 1 3 3 3 3 3 3 1
1 0 1 2 2 1 0 0 0 1 2 2 2 2 2 2 2 2 2 2 2 2 2 2 2 2 2 4 3 3 3 3 3 3 3 3 3 3 1 0 0 1 3 3 3 3 3 1 1 1 1 1 1 3 3 3 3 3 3 1
1 0 1 2 2 1 0 0 0 1 2 2 1 1 1 1 1 1 1 2 2 1 1 1 1 1 1 1 3 3 3 3 3 3 3 3 3 3 1 0 0 1 3 3 3 3 3 4 4 4 4 4	3 3 3 3 3 3 3 1
1 0 1 2 2 4 4 0 0 1 2 2 1 0 0 0 0 0 1 2 2 1 0 0 0 0 0 1 3 3 3 3 3 3 3 3 3 3 1 0 0 1 3 3 3 3 3 4 4 4 4 4 3 3 3 3 3 3 3 1
1 0 1 2 2 4 4 0 0 1 2 2 1 0 0 0 0 0 1 2 2 1 0 0 0 0 0 1 3 3 3 3 3 3 3 3 3 3 1 0 0 1 1 1 1 1 1 1 1 1 1 1 1 1 1 1 4 4 4 1
1 0 1 2 2 4 4 0 0 1 2 2 1 0 0 0 0 0 1 2 2 1 0 0 0 0 0 1 3 3 3 3 3 3 3 3 3 3 1 0 0 0 0 0 0 0 0 0 0 0 0 0 0 0 0 1 4 4 4 1
1 0 1 2 2 4 4 0 0 1 2 2 1 0 0 0 0 0 1 2 2 1 0 0 0 0 0 1 3 3 3 3 3 3 3 3 3 3 1 0 0 0 0 0 0 0 0 0 0 0 0 0 0 0 0 1 4 4 4 1
1 4 1 2 2 1 0 0 0 1 2 2 1 0 0 0 0 0 1 2 2 1 0 0 0 0 0 1 3 3 3 3 3 3 3 3 3 3 1 0 0 0 0 0 1 1 1 1 1 1 1 1 1 1 1 1 4 4 4 1
1 4 1 2 2 1 0 0 0 1 2 2 1 0 0 0 0 0 1 2 2 1 1 1 1 1 0 1 3 3 3 3 3 3 3 3 3 3 1 0 0 0 0 0 1 2 2 2 2 2 2 2 2 2 2 2 2 2 2 1
1 4 1 2 2 1 0 0 0 1 2 2 1 0 0 0 0 0 1 2 2 2 2 2 2 1 0 1 3 3 3 3 3 3 3 3 3 3 1 1 1 1 1 1 1 2 2 2 2 2 2 2 2 2 2 2 2 2 2 1
1 0 1 2 2 1 0 0 0 1 2 2 1 0 0 0 0 0 1 2 2 2 2 2 2 1 0 1 3 3 3 3 3 3 3 3 3 3 4 2 2 2 2 2 2 2 2 1 1 1 1 1 1 1 1 1 1 4 4 1
1 0 1 2 2 1 0 0 0 1 2 2 1 0 0 0 0 0 1 1 1 1 1 2 2 1 0 1 3 3 3 3 3 3 3 3 3 3 4 2 2 2 2 2 2 2 2 1 0 0 0 0 0 0 0 0 1 4 4 1
1 0 1 2 2 1 0 0 0 1 2 2 1 0 0 0 0 0 0 0 0 0 1 2 2 1 0 1 1 1 1 1 1 1 1 1 1 1 1 1 1 1 1 1 1 2 2 1 0 0 0 0 0 0 0 0 1 4 4 1
1 1 1 4 4 1 1 1 1 1 4 4 1 0 0 0 0 4 4 4 0 0 1 2 2 1 0 0 0 0 0 0 0 0 0 0 0 0 0 0 0 0 0 0 1 2 2 1 0 1 1 1 1 1 1 1 1 3 3 1
1 3 3 3 3 3 3 3 3 3 3 3 1 0 0 0 0 4 4 4 0 0 1 2 2 1 0 0 0 0 0 0 0 0 0 0 0 0 0 0 0 0 0 0 1 2 2 1 0 1 3 3 3 3 3 3 3 3 3 1
1 3 3 3 3 3 3 3 3 3 3 3 1 1 1 1 1 4 4 4 1 1 1 2 2 1 1 1 1 1 1 0 0 0 0 0 0 0 0 0 0 0 0 0 1 2 2 1 0 1 3 3 3 3 3 3 3 3 3 1
1 3 3 3 3 3 3 3 3 3 3 3 4 2 2 2 2 2 2 2 2 2 2 2 2 2 2 2 2 2 1 0 0 0 0 0 0 0 0 0 0 0 0 0 1 2 2 1 0 1 3 3 3 3 3 3 3 3 3 1
1 3 3 3 3 3 3 3 3 3 3 3 4 2 2 2 2 2 2 2 2 2 2 2 2 2 2 2 2 2 1 0 0 0 0 0 0 0 0 0 0 0 0 0 1 2 2 1 0 1 3 3 3 3 3 3 3 3 3 1
1 3 3 3 3 3 3 3 3 3 3 3 1 1 1 1 1 1 1 2 2 1 1 1 1 1 1 1 2 2 1 1 1 1 1 1 1 1 1 1 1 1 1 1 1 2 2 1 0 1 3 3 3 3 3 3 3 3 3 1
1 3 3 3 3 3 3 3 3 3 3 3 1 0 0 0 0 0 0 0 0 0 0 0 0 0 0 1 2 2 2 2 2 2 2 2 2 2 2 2 2 2 2 2 2 2 2 1 0 1 3 3 3 3 3 3 3 3 3 1
1 3 3 3 3 3 3 3 3 3 3 3 1 0 0 0 0 0 0 0 0 0 0 0 0 0 0 1 2 2 2 2 2 2 2 2 2 2 2 2 2 2 2 2 2 2 2 1 0 1 3 3 3 3 3 3 3 3 3 1
1 1 1 1 1 1 1 1 1 1 1 1 1 1 1 1 1 1 1 1 1 1 1 1 1 1 1 1 1 1 1 1 1 1 1 1 1 1 1 1 1 1 1 1 1 1 1 1 1 1 1 1 1 1 1 1 1 1 1 1
